###############################
#p * *1  f    *  ** * *      *#
# # # # #*# # #*# # # # # #*# #
#  s * * *** **      *    **  #
# #*# # # # #1# #b#2# # # # #*#
#   b      *     **      *  **#
# # #*# # # # # #*#*#*#*# # # #
#   *        *   * *x* *      #
# # # # #*# # # # # # #*# #*# #
#   ****         *2           #
# # # # # # # # # #*# # # # #*#
#  ** *   *    2              #
###############################

