###############################
#p    * **    *   2   2       #
# # # #*# # # # # # # # # # # #
#      ** * *  *   * ** 2 *   #
# # # # # #*# # # # # # #*# # #
#*   * *    *b* *   **        #
# # # # # # # # # # # # # #*# #
#    *     *        *    **  2#
# #*# # #*#*#*#*# # #1# # #*# #
#        * 2 *2*    *   *     #
#*# # # # # # # # # # #*# # #*#
#x*    * **    ** ***     1   #
###############################