###############################
#p     b* *    *   *  * * *   #
# # # #*# # #*#*# # # #*#*#*# #
#   *      ***  *      *   * *#
# # # # # #*# # #*#*# # # # #*#
#f         x **1 *  *  2      #
# # # # # # # # # #*#1#*# # # #
#*  *      *  *      *        #
# # # # #*# # # #*#*# # # # # #
#*    **  *       *           #
# #*# # # # # # #*# # # # # # #
#           *1  *  *          #
###############################

